111111111111111
100000000000001
100100000000001
100103001111011
100100000000001
100000000000001
100011111110001
110000001000001
100000000000001
100111000001001
100100000010001
100100020100001
100000000000001
100000000000001
111111111111111