111111111111111
100000000000001
100100000000001
100103001111011
100100000000001
100000000000001
100011111110001
110000001000001
100000000000001
100111000001001
100100000011001
100100020110001
100000000000001
100000000000001
111111111111111